#
abenteuerlich = bizarre, adventurous
Aber die gute Nachricht lautet: = but the good news is …
Aber die gute Nachricht lautet: = but the good news is …
aber was wäre mit unseren Kindern? = but what about our children?
aber was wäre mit unseren Kindern? = but what about our children?
abfragen = to enquire, to request, to retrieve
abhören = to intercept (overhear), to eavesdrop, to listen
Abhörschnittstelle, s = listening interface
Abschluss, r (..üsse) = conclusion, closure, graduation, completion, degree
Abwägung, e (-en) = consideration
Abwesenheit, e (-n) = the absence
abwimmeln, jdn = to get rid of sbd
achten | achtete | geachtet = to respect, to regard, to esteem, to venerate
Ackerbau, r = agriculture, cultivation
Affäre, e (-n) = the incident, the romance (affair), scandal, episode, fling
aktionsgetrieben = action-driven
alle Zweifel zerstreuen = to eliminate all doubt
allgemein = generally, commonly, globally, general
Allgewaltiger, r = all-powerful
alltäglich = all-day
Alltags = ordinary
am beliebtesten = the most popular
am ehesten = most likely
am ehesten = most likely, soonest, 
amtierend = incumbent, acting, current (e.g. president)
Amtsantritt, r (-e) = inauguration, taking office, assumption of office
Analysemethoden, e = analysis methods
Anerkennung, e = recognition, appreciation, approval, acknowledgement
anfangen (an/fing, angefangen) = to commence, to begin
angehören = to belong to, to be a member of,
angemessen = adequate(ly), appropriate(ly), suitable(y)
angewandte Wissenschaften, e. = applied sciences
ängstlich = anxious, afraid, scared
angucken = to look at, to take a peek at
anhaltend = ongoing, sustained, prolonged, lasting
Anhänger, r = proponent, supporter, advocate
anklagen | klagte an/anklagte | angeklagt = accuse, indict, charge
Anleitung, e = instruction, guidance
anmelden = register, enrol
ansiedeln | siedelte an/ansiedelte | angesiedelt = to settle, to locate, to place
ansonsten = otherwise, apart from that
anspornen = to spur, to encourage
ansprechen = to bring sth. Up in conversation, to address an issue (e.g. Ah… ich würde gerne noch die Kaffeequalität ansprechen)
ansprechen, jdn = to speak to someone, to address someone
anstellen = carry out / employ (sb), undertake,
anwenden = deploy, apply, utilize, use
Anwendung, e (-n) = application, usage, practice
Anwendung, e = application (e.g. on a smartphone)
Anwendungsbereich, r (-e) = application area
Anwendungsgebiet, s = field of application
Aprilscherz, r (-e) = April Fool's joke
Bei diesem Artikel handelt es sich um einen Aprilscherz = this article is an April fool's joke.
Assistent, r (-en) = assistant
auch wenn = even though
auf das Lenken zu verzichten = abandon steering
auf der anderen Seite = on the other hand
auf der eine Seite = on the one hand
auf etwas + Dat. beruhend = based on sth
aufgehoben = rescinded, revoked, suspended, abolished, reversed
aufklären, erklären = enlighten, elucidate, clarify, educate
aufkommen = arise, emerge, come up
auflegen (das Telephon) = to hang up
auflegen = apply /hang up
aufmarschieren = to muster, march up, deploy
aufpassen = to mind, to be attentive, to take care
aufsagen = recite
Auftrag, r (-äge) = order, remittance, commission, instruction, task, mandate
Aufwachwort, s = the wake-up word
ausdehnen = to expand, to broaden,  extend, spread, stretch
Ausflug, r (-üge) = excursion, outing
ausgehen = to come out (speak), to step out, to burn out (fire), to end, to date (someone)
Auslegung, e (-n) = interpretation, exegesis
Ausmaß, s (-e) = extent, degree, scale, magnitude, size, proportion, depth
Ausprägung, e (-en) = characteristic, peculiarity, manifestation
ausreichend = sufficient, enough, adequate
Ausschnitt, r (-e) = extract, excerpt
Ausschreitungen, e = riots
aussehen = to look (anders aussehen = look different)
außergewöhnlich = strange, extraordinary, sublime, 
außerhalb = beyond, outside, out of,
aussuchen = choose, pick out, select
aussuchen = to choose, to pick
Austauschbeziehung, e (-en) = exchange relationship
austragen = to stage (e.g. war)
ausweichen = avoid
auswendig = by heart
auswendig gelernt = memorized, 
auswerten | wertete aus/auswertete = evaluate, assess, analyze
auswerten = evaluate, alalyse, assess
Auswirkung, e (-n) = impact, effect, outcome, implication, ramification
Auswirkung, e (-n) = impact, implication, effect, outcome, consequence
basierend auf = based on
Bauchhalter, r (-) = accountant
Baumwolle, e (-n) = cotton
bedeutende Frauen und Männer = important / prominent / major women and men
bedingungslos = unconditional
bedrohen | bedrohte | bedroht = threaten, menace, intimidate
Bedürfnis, e (-se) = need, requirement
befasst mit = occupied with
Befehl, r (-e) = order, command, imperative
befriedigen = satisfy, gratify
begegnen = encounter
begehen, etwas = to commit something (e.g. a crime)
Begehung eines Vebrechens = commission of a crime
begreifen = understand, see, recognize
begrenzt = confined, narrow, restricted, finite, delimited
begünstigen = to favor, to promote, to facilitate
behindert = disabled
bei Rot über die Straße laufen = cross the street on a red light
Beifahrer, r = passenger, front-seat passenger
beispiellos = unprecedented, unparalleled, 
beitragen = to contribute, to conduce
Bekenntnis, s (-se) = creed, confession, avowal, acknowledgement, denomination
bemalen = paint
bereits = already
bereits = already, even, as early
bereuen = to regret, to be sorry, repent
bergen = contain, harbout, hide (es birgt = it contains)
berufen = to appoint, to call
beruhend = being based on, based (e.g. auf Erfahrung beruhend = expiential)
besagen = to prove, to say, state, imply
beschaffen (eingeben) = supply (sich etw. beschaffen = to obtain sth.)
Beschaffung, e (-n) = procurement, acquisition, purchase
bescheiden = modest, humble, frugal, unassuming
Bescheidenheit, e (-en) = modesty, humility humbleness
beschimpfen | beschimpfte | beschimpft = insult, abuse, berate, scold, attack
besiegen = vanquish, conquer, defeat
besitzen = to have got, to possess
besprechen = to review, to discuss
beständig = constantly, consistently
bestätigen = confirm, acknowledge, verify, approve, 
bestehen die Prüfund = pass the examination
bestreiten = dispute
Betätigungsfeld, s = field of activitiy/operation (e.g. humanities, science, etc.)
Beteiligte, r (-n) = participant
betonen = emphasize, stress, accentuate
Betonung, e (-en) = emphasis, stress, accent, intonation
betrachten = consider, regard, contemplate, view
Betroffene, r (-n) = the people affected
betrügen (betrog, betrogen) = to cheat, betray, deceive
beziehen (sich auf etw.) = to refer to sth
beziehungsweise = respectively, alternatively, or, or rather, or that is to say
bezüglich = regarding, respecting, as to, relative to
bis zum / zur = until
bisher = so far, until now, hitherto, up to this point
bislang = so far
Bohne, e (-n) = bean
Botschaft, e (-n) = message, communication / Embassy
Bremsen, e = the brakes (of a car)
brisant = controversial, explosive, volatile
Bundesanwaltschaft, r = the Federal Prosecutor’s Office
Bundesregierung, e = the federal government
Chef, r = boss, chief, head, employer, principal
chinesischer = chinese
Christ, r (-en) = christian
Crash, r (-s) = the crash
Da haben wir einen langen Weg vor uns = we still have a long way to go
dadurch = thus, thereby, therefore, in this way
dafür = for that reason, for this, for that
dagegen = by contrast, in contrast, however, on the contrary, the other hand
damals = in those days
damals bloß dabei = back then
damit solche Dinge nicht mehr passieren = so that such things never happen again
dank Alexa = thanks to Alexa
dankbar = thankful
dann legte sie auf (den Hörer auflegen) = she then hang up
darüber hinaus = furthermore, in addition, beyond that, besides, what's more, apart from that
darum geht es gar nicht = that’s not the point
darum geht es um nicht = that’s not what we are about
das autonom fahrende Auto = the autonomously driven car
das fällt einem leicht = doing that is easy
das Geld fällt nicht vom Himmel = money does not grow on trees
das geringere Übel = the lesser evil
das ist mir jetzt klar = it’s clear to me now.
das kommt darauf an = it depends
das kommt mir ungerecht vor = that seems unfair to me
das stimmt = that is true
das System arbeitete so, wie es designt wurde. = The system worked the way it was designed
das wird an [einem kleinen Gespräch] deutlich, dass… = this becomes clear from a small conversation which I found in a small 
dass Leute nach Amputationen noch für einige Wochen einen Phantom Glied spüren = that weeks after the amputation people feel a phantom limb
dass Man eine Nadel hätte fallen hören können = that one could have heard a needle fall.
Datenschützern, e = data protectionists
Dazu ist erschiennen der Sohn Gottes = for this purpose is the son of God manifested
Deckname, r = code name, pseudonym, alias
denn je = than ever (starker denn je = stronger than ever)
dennoch = nevertheless, still, however
der Angriff | die Angriffe = the attack
der Beschuldigte/ein Beschuldigter | die Beschuldigten = the accused person(s)
der brennende Dornenbusch = the burning thorn-bush
der Ermittler | die Ermittler = the investigator, the detective
der junge Mann verliebt sich in das hübsche Mädchen = The young man falls in love with the pretty girl
der Tag der deutschen Einheit = the day of German unity
der Umlauf | die Umläufe = circulation
der Verdacht | die Verdächte = suspicion
der Verdacht is gegen deine Schwester gerichtet = the suspicion is directed against your sister
derzeit = currently, at present, for now
dialogorientiert = conversational, dialog oriented
dick = fat, thick
die allermeisten = the majority
die Art und Weise = the way in which, the manner in which, the way
die Beschaffung von Flugzeuge = the procurement of airplanes
Die Bremsen seines Autos haben versagt = the brakes of his car have failed
die Zeit heilt alle Wunden = time heals all wounds
Dieb, r (-e) = thief
diejenige = the one
diejenigen = those, the ones
diskutieren = discuss
doch geht das eigentlich? = but is that really possible?
Dogmatik, e (-n) = dogmatics, legal doctrine
Domänenspezifisch = domain specific
dringlich = pressing, urgent
durchsagen = to announce
Durchsetzung, e (-n) = implementation, enforcement
durchtrainiert = thoroughly fit, well trained
Ebene, e (-n) = tier, level, rank
Ebene, e = tier, plane, level, rank
ecken = to frame (a painting)
Ehegattin, e (-n) = spouse (female)
eher = rather, sooner, earlier, 
eher = sooner, earlier
ehrfurcht-gebietend = awe-inspiring, imperious
eigener = own, separate (eigener Bruder = own brother / eigener Eingang = separate entrance)
Einbettung, e (-en) = embedding, incorporation
Einblick, r (-e) = insight, view into
eindrucksvoll = impressive, spectacular, awesome, forceful
eine Entscheidung treffen = to come to a decision
einengen (beschränken) = to narrow
einfältig = simple, naive, simple-minded, bovine, fatuous
einflussreichste = most influential
eingreifen = to intervene, to interfere
einige von ihnen = some of them
einleiten | leitete ein/einleitete | eingeleitet = to initiate to commence
Einleitung, e = introduction
einsetzen = utilize, install, use, employ, introduce
einstellen = to appoint, hire, recruit
einstimmen = tune up, to put in the right mood.
Eintretenswahrscheinlichkeit, e = probability of occurence
Energieeffizienz, e = energy efficiency
Enkel, r = grandchild/ren, grandson
Enkelkinder, e = grandchildren
entdecken = discover, spot, detect, spy
entfallen = omit, drop (entfiel, entfallen)
entgehen = avoid, escape, evade
entscheiden = decide, to opt for
entscheidend = crucial, vitar, ciritical
Entscheidungsträger, r = decision maker
entstehen = arise, result, form, occur, develop, emerge, accrue
Entstehung, e = the emergence
entstellen = distort, misrepresent, disfigure
entweder … oder = either ... or
entwicklungsgeschichtlich = evolutionary, from an evolutionary point of view
er gibt seinen Namen preis = He reveals His name
er gibt von sich preis = he reveals himself
er hat sich verharmlosend geäußert = he had expressed himself (about sth) in belittling terms
er ist/sitzt in Haft = he is in custody
er liegt beim Rennen in Führung = he's leading the race
Er sieht das ähnlich = he has the same view
erbitten = solicit, request, petition, ask for
erbost = furious, incensed, angry
erfahren = to learn (be informed), to hear, to learn, to undergo
Erfolg, r (-e) = success, prosperity
erhalten = obtained, received
Erkennen, s = knowledge, cognition
erklingen = to ring, to sound, to resound
erleben = to experience, to witness, to undergo
Ermäßigung, e = allowance, reduction, rebate
Ermittlung, e (-n) = investigation, inquiry
ermorden, jdn = to murder, to assassinate, to kill
Ernährung, e = diet, eating habit	
Ernährungswissenschaft, e = nutritional science; dietectics
erscheinen = appear, emerge, manifest
erst im vergangenen Monat = just last month
Erwachsener, r = adult
erwähnt = mentioned
erzielen = realize (price), achieve, attain, obtain (result)
es dauert nicht (mehr) lange, bis … = it won’t take long before …
es fällt mir leicht, etw. zu tun = I have an easy time doing that
es fehlt = something is missing
es geht doch nichts über = you can’t beat
es geht immer um Informationen = it’s always about information
es geht nicht = it’s impossible, it won’t work (zb. Ohne Personalisierung geht es nicht = personalization is essential)
es geht um … = it’s about …
es gilt als wahrscheinlich = it is considered as probable
es ist aber auch eine Art Fluch = it is also a kind of curse
es ist eingeschaltet = it is switched on
Es ist ihm peinlich = he is embarrassed
Es ist mir aufgefallen = it occured to me
es kam = it happened
es legt zudem nahe = it also suggests
es war so still, dass ein Mann eine Nadel fallen hören konnte = it was so silent that a man could hear a needle fall.
es wird empfohlen = it is recommended
eskalieren = to escalate
Essgewohnheiten, e = eating habits
etablieren (gründen, begründen, festsetzen) = establish
etliche, einige = several, quite a few
etw. ansprechen = to address sth (topic, subject), to broach
etw. aufklären = to solve sth.
etw. begründen = to justify sth.
etw. beruht auf [+Dat.] = sth has been based on…
etw. erheben = claim (e.g. power): Macht erheben = to claim power / to compile (data)
etw. geben = to teach sth.
etw. leihen = borrow sth.
etw. vermögen = to be able to do sth., capable of doing sth.
Exponent, r (-en) = exponent
exponentiell = explonentially, exponential 
Fach, s (pl. Fächer) = discipline, subject
Fachblatt, s (-ätter) = professional magazine, specialist magazine, journal
Fähigkeit, e (-n) = ability, skill, capability, faculty
Fahrt, e = run, drive, journey, travel
fakultativ = optional, voluntary
fassen = grasp, conceive, comprehend
fehlen = to lack, to miss
fehlinterpretieren = interpret falsly, misinterpret
festlegen = determine, predefine, stipulate, schedule
Festnahme, e (-n) = the arrest
festnehmen = detain, arrest, seize
finanzielle Lage = financial stanting / situation
Flugblatt, s (…blätter) = leaflet, broadsheet, flyer
Forstwissenschaft, e = science of forestry; forestry science	
fortan = from then on
fortfahren = continue (e.g. saying someting)
Fortschritt, r (-e) = progress
fortsetzen | setzte fort/fortsetzte | fortgesetzt = to resume, proceed, continue
Franz, wärst du so freundlich … = Franz, would you be so kind …
frech = cheeky, bold, brazen, sassy, naughty, insolent, fresh
fundamental, grundlegend = fundamental, basic
furchtbar = awful, dreadful, terrible
Furchtgebietender, r = all-fearful
fürsorglich = caring, considerate, attentive
Gatte, r (-n) = spouse (man)
geäußert = expessed, uttered, voiced
Gebete, e = prayers
Gebot, s (-e) = commandement, imperative, order (zen Gebote = ten commandements)
Gebrauch, r (Gebräuche) = use, practice
Gedanke, r (-en) = thought
gefährliche Lage = dangerous position/situation
Gegenstandsbereich, r = subject area, universe of discourse
gegenwärtig = today, currently, presently (es geschieht gegewärtig = it is happening now)
Gehirn, s (-e) = brain
gehoben = sophisticated
geistig = mental
gelähmt = petrified, paralyzed, crippled
Geld leihen = advance money / to lend money
gelingen | gelang | gelungen = succeed, am successful
gelten als = is/are considered
Gemälde, s (-) = painting
gemäß = according to …
gemeinsam = common, mutual, together
Gemeinschaftlich = common, communal, joint
Generalbundesanwalt, r = the Federal Attorney General
generieren = to generate
genügend = sufficient, ample, adequate, satisfactory
gerade damit = just so that
geradezu = downright, literally, virtually, 
geraten | geriet | geraten = to get into (a place, a situation), advised
Geschäft, s (-e) = business, establishment
Geschichtswissenschaft, e = science of history; history as a science
Geschlecht, s (-er) = gender, sex
Geschirr, s (-e) = dishes, crockery, tableware, dishware, vessel, harness	
Gespräch, s (-e) = conversation, talk, dialogue
Gesprächsausschnitte = snippets of conversations
geteilt = shared, apportioned, divided
getragen = worn out, second-hand (for clothes), 
getrieben = driven, chased, impelled
gewähren (+ in) = to grand, to afford, to allow, impart, bestow
Gewerbe, s (-) = trade, industry, profession, farm
gewiss = certainly
gewisse = certain
Gewissen, s = conscience
Gewohnheit, e (-n) = habit, custom, manner
Glaubensbekenntnis, s (-se) = Creed, statement of faith
Glaubenszeugnis, s (-se) = testimony of faith
glaubwürdig = credible, reliable, trustworthy, believable
Go through the bridge and take the left sidewalk which will lead you to a ground elevation upon which is the grave = Gehen Sie durch die Brücke und entland den linken Bürgersteig, der Sie zu einer Anhöhe führt, auf der sich das Grab befindet.
Gottesdienst, r (-e) = mass, service, liturgy
Gräueltat, r (-en) = atrocity 
Greis, r (-e) = an old man
grelle = glaring (e.g. light = grelles Licht)
großartig = magnificent, great, splendid, superb
größenwahnsinnig = megalomaniac
Grundgedanke, r = fundamental idea
grundsätzlich = basic, principal, fundamental
günstig = favorable, convenient, advantageous, generous, beneficial (Konditionen)
Handelsfaktor, r = commercial factor
handgeschrieben = handwritten
hart Kurs = hard course
Hartnäckig = stubborn, persistent, tenacious,
häufig = often
häufiger = more frequently, more often
Häufigkeit, e = prevalence, frequency, commonness (of occurrence)
Hauptsächlich = primarily, mainly
heilen = cure, heal
hellhörig = sensitive, keen-eared
hemmend = inhibitory, inhibiting, stunting, retardant, obtrusive
herausfinden = to figure out, to find out, to ascertain, to come to the bottom of…
Herausforderung, e (-n) = challenge
herauskommen = to result, issue, emerge, come out, come forth
Hersteller, r (-) = manufacturer(s), producer(s), maker(s)
Herstellung, e = manufacture, production
hervorgehen = arise, emerge
Hetzjagd, e (-n) = hunt, hounding, ´smear campaign´,
hindern = to hinder, to prevent, to detain
hindeuten = indicate, suggest, portend
hindurch = through, throughout
hingegen = on the contrary, whereas 
hinrichten | richtete hin/hinrichtete | hingerichtet = to execute
Hirnforschung, e = brain research
Höhlenwand, e (-wände) = cave wall
holen = to fetch, to bring, to call
Hörsaal, r (p. Hörsäle) = auditorium, lecture hall
hüten = to tend (sheep), to keep, to shepherd
I can’t wait to be part of the new and glorious age, the digital age. = Ich kann es kaum erwarten, Teil des neuen und glorreichen Zeitalters zu sein, des digitalen Zeitalters.
I don’t measure up to the task = Ich bin der Aufgabe nicht gewachsen.
Ich denke, also bin ich = I think, therefore I am
Ich frage mich = I wonder if, I am wondering if
Ich frage mich, ob das alles seine Richtigkeit hat. = I wonder if this is all right / I wonder if all this is true
Ich kamm zu dem Schluß, dass … = I came to the conclusion that …
Ich lege nie das Telefon auf, ohne mich zu verabschieden = I never hang up the phone without saying goodbye
Ich stelle eine Frage = I ask a question
Zeitungsberichten, e = newspaper reports
Ich stelle mich lieber tot = I thought I´d rather play dead
Ich verwähle mich am Telefon = I misdial a number on the telephone
Ikon, s (-e) = icon
in der Regel = normally, usually, as a general rule
Sachtext, r (-e) = factual text
Gebrauchsanweisungen, e = instructions for use
im Auftrag + Gen. = commissioned by, on behalf of (im Auftrag des Kunden = im Namen des Kunden)
im Folgenden = below, hereafter, hereinafter, in what follows
im Rahmen + Gen. = during, as part of, in the scope of, in the context of, for the purpose of, within the framework of
im Raum = in the area of …
im Schnitt = on average
Im Sinne + Gen. = in the sense of …
Im Verlauf des letzten Jahres … = in the course of the previous year …
Imagination, e = imagination
in beiden Fällen = in both cases
in den 1960er Jahren = in the 1960s
in den Neunzigerjahren gab es den Kampf um … = in the 1990´s there was the competition about
in den Neunzigerjahren gas es den Kampf um … = in the 1990´s there was the competition about
in der Praxis = in practice
in Gefahr greaten = run into danger, get into danger
in immer stärkerem Ausmaß = to an ever-increasing extent
in Kauf nehmen = to accept, take into account
in Richtung = in the direction of
Indem = by, while, whilst, as
Individuum, s (die Individuen) = the individual
Indiz, s (-ien) = clue, indication, evidence, sign
Informatik, e = informatics, information science
Informationsgeselschaft, e. = information society
informell | informeller | am informellsten (adj.) = informal, casual
Ingenieurwissenschaft, e = engineering science	
Inhaber, r (-) / Inhaberin, e = owner, proprietor, property owner
innerhalb = within, inside
Input – Output = Eingabe - Ausgabe
ins Leere laufen = to come to nothing
Insbesondere = in particular
inzwischen = by now, meanwhile
irgendwann = at some point, anytime, sometime, some day 
Irgendwelche = any, any desired
ist noch unklar = … it is still unclear
jd mit Ecken und Kanten = somebody with a mind of his own
jmd. etw. gewachsen sein = he/she can cope with, be up to sth, stand up to sth., measure up to sth
jmd. in den Sinn kommen = it occurs to sbd.(?)
jmdn. ansprechen = to address somebody
jmdn. / etw. darstellen = to represent sbd/sth., to depict
je = ever
Notstand, r (-stände) = crisis, contingency, distress, state of emergency
jede Antwort auf eine Frage birgt eine neue Frage = every answer to a question raises a new question
Jedenfalls = in any case
jedoch nicht = however not
jeglicher = every, each, any…whatsoever, all, of any kind
mit Gewalt = forcefully, forcibly, by force
onhen Gewalt = without violence
jeglicher Art = of all sorts
Jemandem (jdm) = someone
jene = that/those (pron.)
Ich kann es mir kaum leisten = I can't afford it
Das kann ich nicht nachvollziehen = I can't understand it
Ich kann mir nicht helfen = I can't help it
kapieren = to understand, to figure out, 
keine Ermäßigung = no reduction/discount
Klang, r (Klänge) = sound, tone
Klausur, e (-en) = test, exam
knipsen = to snap
Kognitionswissenschaft, e = cognitive science	
Kollision, e (-en) = collision
Kommandos erhalten = to receive commands
Kommunikationswissenschaft, e = communication science	
Kompost entsteht durch die Verwesung organischer Stoffe = Compost is formed through the decomposition of organic matter
konkurrieren = compete
Krake, r (-n) = octopus
kratzig = scratchy, rough, 
Krawall, r | die Krawalle = the riot
Krebszelle, e (-n) = cancer cell
Kriterium, s (-rien) = the criterion
Kulturveranstaltung, e = cultural event
Kundenvertrauen, s = customer trust
künftig = future, in the future
Künftig = in future
Lage, e (/n) = position, situation
Es dauerte etwa zwei Millionen Jahre = it took about two million years
lähmen | lähmte | gelähmt = petrify, paralyse, cripple
Lautsprecher, r (-) = speaker, loudspeaker
lebendig(er) = lively
Lebensgefahr, e (-en) = risk of death
lediglich = merely, solely
Lehrveranstaltung, e (-n) = seminar, course, lecture
Leib, s (-er) = body, trunck, belly
Lenken, s = steering
Lesevorlieben, e = reading habits
letztwillige Verfügung, e = last will, testamentary disposition
Liebst du mich eigentlich? = do you really love me?
Liga, e = league, division
Lohnkürzung, e (-en) = pay cut, wage cut, wage reduction, cut in wages
lösen = to solve, resolve
lückenhaft = incomplete, sketchy
Maschine anmachen = to turn on the machine
Machtanspruch, r (-üche) = claim to power
marktbasiert = market-based
Marktreif, e (-) = market maturity
Maßzahl, s (-en) = measured value 
Materialwissenschaft, e = materials science	
meine Gedanken und Gebete sind bei dir = my thoughts and prayers are with you
meinen Gedanken an etw. teilen = share my thoughts on sth.
meist nur = in most cases only, usually only, mostly just
Menschheit, e (-n) = the human kind, humanity
Millionenstadt = megacity
mir geht das Herz auf = I´m getting my heart racing
missbrauchen = to abuse, to put to ill practice
mit Hitler anlegen = to mess up with Hitler
mitbekommen = to realize, notice
mitbringen = bring along
mithören = to overhear, to listen on to sth.
mittlerweile = meanwhile
mitschneiden = to record sth (phone conversation, etc.)
mitsprechen = say together, repeat (as of prayers)
Mitstreiter, r = comrade-in-arms, allies
Mitte des 20. Jahrhuderts = mid-twentieth century
mitteilen = communicate, inform
mittlerweile = in the meawhile
Molekül (-e), s = molecule
Moos, s (-e) = moss, bread, dough
mühsam = painstakingly, laboriously, tedious, arduous
Musikalischen Präferenzen = musical preferences
Muster, s (-) = pattern, model
mutmaßlich = probable, conjecturable
nach Angaben = according to, according to information
nach dem zweiten Weltkrieg = after the Second World War
Nach einem empirischen, testreichen und demonstrierenden Protokoll besagt die Wissenschaft, dass dein Gott nicht existiert. = According to an empirical, test-proof and demonstrative protocol, science states that your God does not exist.
Nachbar, r (-n) = neighbor
nachdrücklich = firmly, emphatically, insistent
nachfragen = inquire, ask again, request
Nachrichtendienst, r. = intelligence service
nachschauen = to look after (to follow sb with one’s own eyes)
nahezu = almost, nearly, approximately (nahezu blind = almost blind)
namenlos = nameless, unnamed, anonymous
nass = wet, soaked
naturwissenschaftlich = scientific
neben = apart from, in addition to, other than, aside from
Nebenprodukt, s (-e) = byproduct
nichts von alledem = none of these things
Note, e (-n) = mark, grade (in education)
Notendurchschnitt, r (-en) = grade point average
nur knapp = only just, just barely
Nutzer, r (-n) = the user
Obdach, s (-) = shelter
obdachlos = homeless
oben erwähnt = above mentioned
Herr Ober! = waiter!
obgleich = albeit, although, though, whereas, as
offenbaren (sich) = to reveal, to manifest (oneself)
ohnehin = anyway, anyhow
Ökonomik, e = political economy	
Paukenschlag, r (-schläge) = sensation, bombshell,
peinliche Lage = embarassing / awkward situation
Pfarrer, r = minister, vicar, parson
Plagiat, e (-e) = plagiarism
pleite (adj.) = broke, bankrupt
Pleite, e (-n) = bankruptcy
politisch Andersdenkende = political dissenters
politisch brisant = politically charged
Populärwissenschaft, e = popular science	
prägend = formative, 
prägender Eindruck = formative impression	
prägendes Erlebnis = formative experience	
praktizieren = practice
Prediger, r = preacher
Predigt, e (-n) = sermon, preaching, homily
Predigtlehre, e (-n) = omiletics, preaching
Preis, r (-e) = the price
Proband, r (-en) = test subject, guinea pig
Probelauf, r (..läufe) = test run, trial run
Profit erzielen, Profit schlagen = make a profit
Prosperität, e (-e) = prosperity
provozieren = to provoke, to cause
Psychosomatische Erkrankungen = psychosomatic disorders
Quellenangabe, e (-n) = reference, list of sources
Rahmen, r (-) = frame, framework, scope
rasen auf die Straße = to rush, race, speed towards the street
Rasen, r (-) = lawn, turft, grass, speed
räumen, etwas = to vacate sth., to clear, leave (a post)
reagieren = react, answer
Rechenleistung, e = computer power / performance, computational power
Rechtfertigung, e = justification, defense, apologia
Rechtsextreme, r (-n) = right extremist
Referat, s (-e) = paper, presentation, report (academic)
Reichtum, r = wealth
Reichweite, e (-n) = range, scope, reach
Religionspädagogik, e = religious education
Rennen, s (-) = race, racing
renommiert = renowned, famous
retten = rescue, salvage, save
retten = rescue, save, 
richten = to introduce, to initiate
Richtlinie, e = Directive
riesig = huge, enormous, vast
ringen = wrestle, grapple, contend, struggle
Risikoanalyse, e = risk analysis
riskieren = risk
Roter Faden, r = common theme
routinemäßig = routinely
Rückmeldung, e = feedbak
Ruf, r (-e) = reputation, fame
sächsisch = Saxon, Anglosaxon
Samenkorn, s (-örner) = seed, corn
Satzergänzung, e (-n) = object, sentence compliment
Schadenausmaß, s = severity, extent of loss, extent of damage
Schaf, s (-e) = sheep
schätzen = assume, reckon, estimate
Schaukelstuhl, r (..ühle) = rocking chair
scheinbar = seemingly, apparently, ostensibly, quasi
Schicht, e (-n) = layer, shift (in jobs), stratum
Schlagzeilen machen = to make headlines
Schlimmere Aktion = worse action
Schlimmstfall Szenario = Worstcase Szenario, worst case scenario
Schlussfolgerung, e = conclusion, inference, implication
Schnittstelle, s = interface
schon = yet, even, 
schon erwähnt = aforementioned
Schriftzeichen, s (-) = graphical characters (e.g. Chinese)
Schublade, e (-n) = drawer
schüchtern = shy, timid, bashful, coy
Schusswaffen, e = firearms
schützen = protect
Schwiegermutter, e = mother-in-law
Schwiegervater, r = father-in-law
Segen, r = blessing, benediction
sehr besorgt = very worried
Seide, e (-n) = silk
seither = since then, ever since, since
Selbstlernend = self-learning
senken = reduce, lower, drop, sink, plunge, decline
Sessel, r (-) = armchair
Sesshaftigkeit, e = sedentariness
sich etw. ansehen = to examine, to look over, 
sich etw. + Dat. erhoffen = hope for sth.
sich etwas + Dat. widmen = to attend to, to address oneself to, to apply oneself to, to dedicate oneself to,
sich mit etw. befassen = to concern/occupy onself with something
sich mit etwas + Dat. auseinandersetzen = to discuss, to grapple with, to deal with, dispute
sich nähern = to advance, to come near, to draw closer
sich verlassen (auf) = rely on
sich vermehren = multiply, propagate, reproduce (sich vermehren wie die Kaninchen = reproduce like rabbits)
sich vorstellen = introduce (myself)
Sich wie ein roter Faden durch etwas ziehen = run through sth like a golden thread
Sie dürfen die rote Ampel nicht überschreiten = you are not allowed to violate the red light
sie schauen so Ernst = you look so serious, grave!
Sinn, r (-e) = sense, mind
Sitte, e (-n) = custom, convention, tradition, fashion, practice, morals
smart = smart
so = for example, so
so dass = so that               
so dass wir = so that we
so gut wie = almost, practically, just about, pretty much, as good as, virtually
sobald = as soon as
sogar = even
sogenannt = so-called, commonly called
Solange = as long as
sollen = ought, are said to …
Sonde, e (-n) = probe, orbiter, tube, explorer
Sonderzeichen anzeigen = display special characters
Soziale Position, e = social position
Sozialwissenschaft, e; Gesellschaftswissenschaft, e = social science
Sprachverständnis, s = speech recognition
spülen = to rinse, to wash (e.g. dishes)
Spur, e (-n) = trace, track, trail, hint
stammen von = to come from, to originate from
ständig = constant, perpetual, permanent
Staunen, s = wonder, astonishment
stechen, stach, gestochen = prick, bite, stick, stab
steht die Erkenntnis = there is the realization
Steinwerkzeug, s (-e) = stone tool
stets, immer = always, steadily, unfailingly, constantly, at all times
Stiftung, e (-en) = foundation (institution), charity, endowment
Stil, r (-e) = the style
Stimmenklang, r = (tone of) voice
Stoff (-e), r. = matterial, stuff
Straftaten, e = criminal offences, crimes
Streit, r (-e) = dispute, argument, controversy
strukturbildend (adj.) = structure-building
stundenlang = for hours
Szenario, s (-rie) = scenario
tarnen = to disguise, to camouflage
Tatvorwurf, r (…würfe) = the criminal charge, accusation
Telefonat, s (-e) = phone call
Tendenz, e (-en) = tend, trend, bias
terroristische Anschläge = terrorist attacks
Terroristische Vereinigung, e = terrorist organization
Terrorvereinigung, e = terrorist organization
Todesstrafe, e (-n) = death penalty, capital punishment
trauen = trust
Treffer, r (-) = hit (as in find something)
Treffpunkt, r (-e) = gathering area, meeting place/point
treten | trat | getreten = kick
über ausreichend Rechenleistung verfügen = to have sufficient computing power
überfahren = to overun, to run over
überfallen | überfiel | überfallen = raid, attack, assault (e.g. a shop, house, etc.)
übergriffen = to encroach, to overlap
Übergriffen, e = assaults
überlegen = consider
übernehmen = to assume (responsibility, liability, office, etc.), to undertake (task, duties, etc.), to adopt sth (an opinion, etc.)
übernehmen = to assume, to borrow (an idea), take up, apply
übernommene Antworten = second-hand / assumed / accepted answers
überraschend = surprising, unexpected
überschreiten = to exceed, to transcend, to overshoot
übertragen = broadcast, convey, assigned, endorsed, communicated
Übertragen, s = transferring (of info.), the broadcast
übertreffen = to exceeed, to surpass, to outstrip
Überweisung, e = bank transfer, remittance, cash/money transfer
übrig = residual, left, remaining
um den Service reizvoller für unsere Kunden zu machen = in order to make our service richer for our customers
um dich herum = around you
um etw. nachfragen = request sth
Umgang, r (-äge) = dealings, contact, company of friends
umgehend = immediately,
unbedingt = absolutely, necessarily, categorically, unconditionally
unbeteiligte Beobachter = uninvolved observer
Und das gelingt ihnen auch = and they succeeded
und selbst wenn = and even if he did
und steht im Mittelpunkt = and is the focus of attention
unfreiwillig = unwilling(ly)
ungeschickt = awkward, clumsy
ungestraft = unpunished, guiltless
ungünstig = ackward, unfavorable, adverse, inconveniet
unmittelbare Folge, e = direct consequence
Unsagbare, s = the unspeakable
Unsinn, r = nonsense
untergeordnete = subordinate, minor
Untergrund, r. (pl. –ünde) = subsurface, substratum, underground
Unterhemd, s = undershirt, vest, φανελάκι
unternehmen = undertake, dare do
Unternehmen, s = company, enterprise
Unternehmer, r = entrepreneur
Unterricht, r (-e) = teaching, classes, instruction
Unterrichtsprogramm, s (-e) = syllabus
Untersagt (verboten, unerlaubt) = forbidden
unterschätzen = underestimate, undervalue
unterscheiden = differentiate, distinguish
Unterschlagen = embezzle, misappropriate
unvollkommen = imperfect(ly), defective(ly)
Urenkel, r = great-grandchild/ren
Urknall, r. = big bang
verabreden | verabredete | verabredet = to arrange (ein Treffen verabreden = to arrange a meeting.)
Verabredung, e (-en) = appointment, date, engagement
Veranstaltung, e = event, meeting
Verbraucherschutz = customer protection
verbrennen = to incinerate, to scortch, burndown (e.g. der Dornbusch brennt aber nicht verbrennt)
verbündete (adj.) = sb allied
Verbündete, e (pl) = the allies
verehren = worship, adore, revere
vereinbaren = to arrange, to agree, to make a deal
vereinnahmen = monopolize, take up, make demands (e.g. er wird vom Beruf ziemlich vereinnahmt = his job takes up much of his time)
Verfassungsschutz, r = protection of the constitution, intelligence service
verfolgen = persecute
verfügen = to command, enact, decree, mandate, order
verfügen über = to have available, to have at one’s own command
verfügung = disposal, (make available), decree, order, disposition, …
Verfügung, e (-n) = disposal, decree, ordinance, direction, regulation
Verfügung, e = disposal, ordinance, order, decree
verführen = seduce, mislead, entrap
verhaften = arrest, capture
Verhaltensweise, e = behavior, behavior patterns
Verharmlosen = to belittle, downplay, trivialize
Verharmlosend = belittling, downplaying, trivializing
Verhörprotokoll, s (-e) = interrogation report
verkaufen = sell, vend, market, dispose of
zu verkaufen = for sale, on offer, on sale
verknüpfen = to relate, to associate, to link
verkünden = preach, declare, proclaim, pronounce,
Verlangen / fordern = demand, require
verlangen = demand, require, request
verlassen (auf) = leave, abandon, forsake
vermehren = increase, multiply, augment
vermehren = to increase, augment
vermieden = avoid, studiously avoid
vermitteln = to convey, to mediate, to communicate (impart)
Vermummte = hooded, masked
vermutlich = presumably, probably
verschalten = to interconnect, to wire up
verschlüsselt = encrypted
verschonen | verschonte | verschont = to spare, to reprieve
verstellen = disguise, adjust
versterben = to die
versuche = try, attempt (Ich versuche nur zu helfen = I’m only trying to help)
Vertrag, r (..äge) = contract, agreement
Vertrauen, s (noun) = trust
vertraute = intimate
Verurteilung, e (-n) = condemnatory sentence, conviction, reprobation
verwählen = to dial the wrong number
Verwechslung, e (-n) = confusion, mix-up, mistake
verwirklicht werden sollen = are to be achieved
Verwirrung, e (-n) = confusion, puzzlement, embarrassment, bewilderment, daze
verwischen | verwischte | verwischt = to blur, smear
verwöhnt = spoiled (e.g. child)
verwundet = wounded
verzichten = abandon, give up
vetreten = represented, represent 
Vieh, s = the cattle
vielfältig = diverse, manifold, varied
Volkswirtschaft, e (-en) = national economy, political economy, political economics
von Amts wegen = ex officio, official(ly)
von Grund = from scratch
vorangehen = proceed, progress, advance, go ahead (lead the way)
voraussetzen = demand, assume, presuppose, require, take for granted
Voraussetzung, e = premise, assumption, supposition
voraussichtlich = probably, likely
Vorbehalt, r (e) = caveat, reservation, restriction
Vorermittlung, e = preliminary investigation
Vorfall, r (-älle) = incidence, occurence
Vorfall, r (-älle) = incidence, occurence, episode, event
Vorgang, r (-gänge) = process, procedure, event, the going-ons, the events
vorgegeben = default, given, predefined, prescribed, preset
vorgegeben = set, prescribed, given
vorhaben = to intend (er hat vor, eine Torte zu backen = he intends to bake a cake)
Vorhersage, e (-n) = prediction, forecast, prognosis
vorläufig = preliminary, provisional, tentative, interim
Vorlesung, e (-n) = lecture, course
Vorstellung, e = imagination
vorzusagen = predict
vorzusagen = predict
Wahrnehmung, e (-n) = perception, cognition, awareness
wahrscheinlich = probably, presumably
wann es dir am ehesten möglich ist = at your earliest convenience
warum fällt es jdn schwer = why is it so difficult for sb.
was auch immer nur versuche = no matter how hard I try
was meinen wir eigentlich damit = what do we really mean by that?
Wecker, r = alarm, buzzer, timer
weder = neither
weder … noch = neither … nor
weiterhin = to keep doing, still
weitläufig = spacious, extensive, roomy
weitreichend = far-reaching
welche Farbe ist deiner Meinung nach vorherrschend = what color do you think is predominant?
Welche Farbe sticht am meisten ins Auge? = Which colour catches the eye most?
Weltall, s. = universe, cosmos
werden sie jedoch oft als gegeben betrachtet = they are often regarded as given (taken for granted)
wertvoll = valuable, precious, worthwhile
weshalb = why, for what reason?
Wettbewerb, r (-e) = competition, contest
Wettbewerber, r (-) = competitor
Wettbewerbsintensitäten, e = intensity of competition, competitive intensity
Wettrennen, s (-) = race, foot race
Widerstand, r (..ände) = resistance
widmen (widmete, gewidmet) = to devote, dedicate, 
wie man Gespräche führt = how to conduct conversation
wiederholen = repeat, recapitulate, reach
Wir stehn im Kontrast zu der großen Mehrheit … = we stand in contrast to the great majority
Wirtschaftswissenschaft, e = economic science
Wissen, s = knowledge
Wissenschaftlich erklären = explain in scientific terms
Wissensgeselschaft, e = information society
Wolle, e (-n) = wool, fleece
worum es hier eigentlich geht? = what is this all about?
wovon = that for which, whereof
wozu = why, wherefore, whereto, what ... for, to what end?
wozu auch? = whatever for?
wozu die Eile? = what's the rush?
wozu diese Umstände? = why all this fuss?
Wovon Mann nicht sprechen kann, davon muss man schweigen = What you cannot speak about, you have to remain silent.
Wüste, e (-n) = desert
zeigen der Hitlergruß = salute Hitler style
Zeitabstand, r (-stände) = time interval
Zentraler Nachrichterdienst, r. = Central Intelligence Agency (CIA)
Zeugnis, s (-se) = testimony, credentials, certificate, testimonial, report, evidence
ziemlich genau = pretty much
Ziffer, e (-n) = digit, number
zu etw. gehören = to be part of sth.
zudem deutlich häufiger = also much more frequently
zuest einmal = first and foremost
Zufall, r = coincidence, chance
Zufluss, r (..üsse) = inflow, tributary, influx
zugänglich = accessible
leidenschaftlich = passionate, passionately, fervent, fervently
Hof, r (Höfe) = yard, courtyard
zugleich = likewise, at the same time, concurently, unanimously, 
Zulässigkeit, e = legitimacy, admissibility
zunächst = initially, primarily
umarmen | umarmte | umarmt = embrace, hug
Zur Kenntnis nehmen = to notice, to take note, to acknowledge sth
zur Verfügung stehen = become available
zur Verfügung stehen = to be available, provide
zurückweichem = to recede, to retreat, to draw back
zusammenführen = to conflate, to merge, to bring together, to join, to combine
Zusammenhang, e (-e) = context
füttern | fütterte | gefüttert = to feed
zusätzlich = in addition, furthermore, besides
zusätzlich = in addition, furthermore, besides
Zweck, r (-e) = purpose, aim, objective
Zweifel zerstreuen = to dissipate/eliminate doubt
zwingen = to force, to compel
zwitschern, singen = tweet, sing (for birds)
οhne einen Schuldbeweis zu liefern… = without furnishing any evidence of guilt…
