advanced = fortgeschritten
affluent, wealthy, prosperous, rich = wohlhabend
again, re- = wieder
agrarian societies = die Acker-Geselschaften
all by themselves = ganz von selbst
ancestor = Ahne, r (-n) (male); Ahne, e (-n) (female); Vorfahr, r (-en)
anführen = to lead, to invoke, to quote, to allege, to cite, to spearhead, to head
argue, claim, assert = behaupten
arm (v.) = bewaffnen (bewaffnete, bewaffnet)
arrow of time = Zeitpfeil, r (-e)
as previously mentioned = wie bereits erwähnt
ascertain, come at sth(discover), find out, figure out = herausfinden
ask a question = eine Frage stellen
assume, suppose, presume, accept, anticipate = etw. annehmen
at the same time = gleichzeitig
perception, conception, opinion, notion, view, understanding, point of view, apprehension = Auffassung, e
because of, based on, owing to, by virtue of, …=  aufgrund + Gen.
belief = Glaube, r (-)
below = darunter, unten, unter
century = Jahrhundert, s (-e)
change, transition = Wandel, r (-)
chicken = Huhn, s, (Hühner)
childhood = Kindheit, e (-en)
cognitive (adj.) = kognitiv
collate = zuordnen, zusammentrangen, zusammenstellen (collation = Zusammenstellung, e)
complain = sich beschweren über etw.
complex, complicated = kompliziert
comprehensive = umfassened, umfangreich, gesamt
concept = Begriff, r (-e), Konzept, s (e)
cover, employ (use), apply, devote, utilize = verwenden, sich befassen mit, bearbeiten
data (n.) = Data, r (-en); Tatsachen, Angaben
decade = Jahrzehnt, s (-en), Dekade, e (-n)
depth = Tiefe, e (-n)
despite = trotz, trotzdem
detect, trace, find-out = aufspüren
direction = Rictung, e
disagree = wiedersprechen, streiten, nicht zustimmen
dive = eintauchen
economic development = wirtschaftliche Entwicklung 
economist = Ökonom, r (-en)
education = Bildung, e; Ausbildung, e
egg = Ei, s (Eier)
equipped / armed with = ausgerüstet mit, ausgestattet mit
evidence = Beleg, r (-e); Beweis, r (-e)
find = finden, entdecken, feststellen
find out, justify, establish = begründen, feststellen
for the first time = erstmals, zum ersten Mal, erstmalig
form = bilden, formen, gestalten
formative years = die präegende Jahre, Entwicklungsjahre, e
fossilized = versteinert
fringe, margin, verge, brink, = Rand, r (Ränder)
function = Funktion, e;  Veranstaltung, e; Tätigkeit, e
give = geben, angeben
in my opinion, to my mind = meiner Auffassung nach
different interpretation = andere Auffassung, e
misapprehension = falsche Auffassung, e
Great Britain = Großbritannien
harden = härten, abhärten
however = jedoch, allerdings, doch, dennoch, hingegen, dagegen, aber
image = Bild, s
imposing, impressive = imposant
in-house, locally, in situ, on site, in the field, on the spot = vor Ort
interpretation = Auslegung, e; Interpretation, e; Übersetzung, e
involve = einbeziehen, einschließen, bedeuten
it cannot be disputed that … = Es lässt sich nicht bestreiten, dass ...
it cannot be expected = Es ist nicht zu erwarten, dass … / nicht erwartet werden kann, dass… / ist nicht davon auszugehen, daß …
it makes no difference to me that … = es ist mir egal, dass…
knot = Knoten, r (-)
lack (of) (n.) = Mangel, r (pl. Mängel); Defizit s (-)
largely, to a large extent = zum größten Teil
lifetime = lebenslang, Lebenszeit, e, 
link (n.) = Verbindung, e (-n), Beziehung, e
major = bedeutend, Haupt- , groß, wesentlich
mature, grow up, come of age = erwachsen (erwuchs, erwachsen)
measure (v.) = bemessen
meet / satisfy = erfüllen 
on the one hand = einerseits, zum einen, auf den einen Seiten
on the other hand = anderseits, zum anderen, auf den anderen Seiten
only since = erst seit
paper (academic work) = Aufsatz, r (-sätze); Arbeit, e; Aufgabe, e
performance (at school, etc.) = Abschneiden, e
performance, power (of a machine) = Leistung, e
periscope = Sehrohr, s (-e)
point, show, exhibit, feature, display, reveal, indicate, depict = zeigen
Political scientist = Politikwissenschaftler, r / Politikwissenschaftlerin, e
pool (v.) = zusammenfassen, bündeln
practical = praktisch
prevent = verhindern, vermeiden, verbeuden, hindern
prevent sbd from doing sth = jdn. an etw. + Dat. hindern, verhindern
productivity = Produktivität, e (-)
Protestant Reformation = protestantische Reformation, e (-n)
prove = beweisen, etw. belegen, nachweisen, prüfen
prove, demonstrate, establish, evince = beweisen
recent = jüngst, neueste, neu
reflect, mirror back = widerspiegeln
relationship = Beziehung, e (-)
research team = Forschungsteam, s
reverse = umgekehrt
rule-out = verdrängen, verwerfen, etw. ausschließen, etw. ummöglich machen
scholar = Wissenschaftler, r (), Gelehrte, r (-n)
secular = säkular, weltlich
secularization = Säkularisierung, e
shortcoming, flaw, deficiency = Manko, s (-s)
to arm oneself = sich bewaffnen
to arm against = bewaffnen gegen
so = so, deshalb, damit, …
social factor = sozialler Faktor
sociologist = Soziologe, r (-n)
solution = Lösung, e; Auflösung, e; Erklärung, e
stampede = Massenansturm, r (-ürme)
statistics = Statistik, e (-n)
steam = Dampf, r (Dämpfe)
steam-powered = dampfbetriebend
sth. is required = etwas is erfordelich / benötigt
straightforward, simple, easy, basic, ordinary = einfach, unkompliziert, direkt
study (n.) = Studium, s (Studien); Untersuchung, e
suppose, assume, presume, conjecture, imagine, guess, expect = vermuten
survey (n.) = Survey, r (-s), Untersuchung, e; Umfrage, e; interviewen
tend to = tendenziell; etw. zu tun/sein; dazu neigen; zu etw.
termporal = zeitlich
the other way around = umgekehrt, andersherum, 
therefore = daher, deshalb, deswegen, also
timeline = Zeitstrahl, r (-en)
to come of age = volljärig werden, erwachsen werden, mündig werden
to occur, take pace, happen = geschehen, stattfinden
to survey, interview, interrogate = befragen 
unleash = auslösen
the greatest common factor of ten and fifteen is five = der größte gemeinsame Teiler von zehn und fünfzehn ist fünf
factor, divider = Teiler, r (-)
common divisor = gemeinsamer Teiler, r
Money was a major factor in the decision = Geld war ein wesentlicher Faktor bei der Entscheidung
unprovable = nicht zu beweisen (mangels Beweisen = for lack of evidence, due to insufficient evidence)
unwittingly = unabsichtlich
ups and downs = die Höhen und Tiefen des Lebens, Schwankungen, e
urge, cajole, push, coax = drängen | drängte | gedrängt
value (n.) = Wert, r (-e)
version = Version, e (-en)
view (e.g. conception, opinion, theory) = Auffassung, e
way = Weg, r (-e); Art, e (-en), Weise, e (-n)
welfare = Sozialhilfe, e; Wohl, s (-)
work ethic =  Arbeitsethik, e (-n)
desperate, frantic, distraught, hopeless = verzweifelt
